rows 8
cols 9
players 2

m %%%%%%%%%
m %...b...%
m %a.%.%.a%
m %..%.%..%
m %..%.%..%
m %a.....A%
m %...B...%
m %%%%%%%%%
