rows 11
cols 9
players 2

m %%%%%%%%%
m %..a.%%%%
m %.%%.%..%
m %.%%...%%
m %%%%.%%%%
m %%%%B%%%%
m %%%%.%%%%
m %%...%%.%
m %..%.%%.%
m %%%%.A..%
m %%%%%%%%%

