rows 11
cols 9
players 2

m %%%%%%%%%
m %....%%%%
m %.%%.%..%
m %.%%...%%
m %%%%.%%%%
m %%%%%%%%%
m %%%%%%%%%
m %B...a.%%
m %.....A.%
m %%.%.%..%
m %%%%%%%%%